NO./textures/64x64/barrel.xpm
SO ./textures/64x64/mossy.xpm
WE ./textures/64x64/pillar.xpm
EA ./textures/64x64/wood.xpm
F 255,111,0
C 225,30,0

   11111111111
   100000000001
  100000000001
 100000000001
100000000001
100000000001
1100000000001
 100000N00001      
  100000000001
 100000000001
 100000000001
 1100000000001
  1000000000001
  111111111111


  1111111
